id,2016,2017,2018,2019,total_commits
blake.newman@sainsburys.co.uk,3,0,0,0,3
chrisvfritz@gmail.com,2,0,0,0,2
evan@evans-mbp.home,0,2,0,0,2
hi@znck.me,0,1,0,0,1
justice360@gmail.com,0,0,0,1,1
kawakazu80@gmail.com,1,0,0,0,1
ktsn55@gmail.com,1,0,0,0,1
me@phanan.net,0,1,1,0,2
noreply@github.com,0,1,3,3,7
posva13@gmail.com,1,0,0,1,2
posva@users.noreply.github.com,5,10,2,10,27
yyx990803@gmail.com,1320,876,290,235,2721
